hero	type
akai	tank
alice	mage
alpha	fighter
alucard	fighter
alutard	fighter
angela	support
argus	fighter
aurora	mage
balmond	fighter
bal****	fighter
bane	fighter
bruno	marksman
chou	fighter
clint	marksman
cyclops	mage
cyc	mage
diggie	support
digger	support
estes	support
eudora	mage
fanny	assassin
franco	tank
gatotkaca	tank
gatot	tank
gord	mage
grock	tank
gusion	assassin
guisson	assassin
gossen	assassin
harley	mage
hayabusa	assassin
haya	assassin
helcurt	assassin
hilda	fighter
hylos	tank
irithel	marksman
iritel	marksman
jawhead	fighter
johnson	tank
kagura	mage
kagu	mage
karina	assassin
karrie	marksman
lance	assassin
lancelot	assassin
lapu	fighter
lapu-lapu	fighter
layla	marksman
lesley	marksman
lolita	tank
mino	tank
minotaur	tank
miya	marksman
moskov	marksman
moskow	marksman
nana	support
nata	assassin
natalia	assassin
odette	mage
odete	mage
pharsa	mage
parsa	mage
farsha	mage
rafaela	support
rafael	support
roger	fighter
ruby	fighter
saber	assassin
sun	fighter
tigreal	tank
valir	mage
vexana	mage
yi sun	marksman
yss	marksman
zhask	mage
zilong	fighter
selena	assassin
chang-e	mage
kaja	tank
uranus	tank
hanabi	marksman
